//格式为日文[Tab]中文[Tab]解释(可不写)，参考项目wiki
館長	馆长	player's name
サンソヴィーノ	桑索维诺	name
アルテ	阿尔特	name
ゴッホ	梵高	name
ドナテッロ	多纳泰罗	name
セキエン	石燕	name
ミケランジェロ	米开朗琪罗	name
レンブラント	伦勃朗	name
アングル	安格尔	name
マネ	马奈	name
ロダン	罗丹	name
ラファエロ	拉斐尔	name
フェルメール	维梅尔	name
ブグロー	布格罗	name
セザンヌ	塞尚	name
モリゾ	莫里索	name
死の芸術	死之艺术
死の芸術業者	死之艺术家
フィオレンツァ	佛罗伦萨	name
キャルト	卡萝特	name
ヘラッテ	赫拉提	name
カティ	卡蒂	name
アデューテ	阿休特	name
ガルテルステ	加尔特尔斯特	name
ツァオ	夏欧	name
ルーヴ	卢浮	name
ディーテ	迪特	name
パンシェ	潘榭	name
アルノン	阿尔侬	name
トルソ	托尔索	name
リヴェルベロ	韦尔贝罗	name
テュルプ	杜尔普	name
ラベレナ	拉贝尔纳	name
シズク	雫	name
バベルウ	巴贝鲁	name
ヴィクトリア	维多莉亚	name
アンジェリーナ	安洁莉娜	name
ディオミステ	迪奥米斯特	name
トレンティーナ	特伦蒂娜	name
ミアヌ	米亚努	name
コンフレーズ	康弗雷兹	name
シュラン	朱兰	name
プロフィーラ	普罗费拉	name
クラマドカ	库拉玛德卡	name
トゥーリ	多莉	name
さつき	皋月	name
ミエーレ	米耶蕾	name
ピエディ	皮耶迪	name
グラマンシュ	格拉曼什	name
セルビオーネ	塞维欧尼	name
エスティー	艾丝媞	name
アンジェラ	安琪拉	name
クラン	库兰	name
ネイト	奈特	name
ルミアン	鲁米安	name
ローリエ	香叶	name
ふたば	双叶	name
フォルジェール	佛洛杰尔	name
スキッピオ	斯基皮奥	name
カプリマ	卡普里玛	name
ヘスデル	赫丝缇尔	name
アンプルーラ	安普尔勒	name
ペルシク	佩尔西克	name
ラズリ	拉兹莉	name
パルマ	帕尔玛	name
キュオ	玖奥	name
ノエミ	诺艾米	name
イマージュ	形象	某一类人
カラヴァッジオ	卡拉瓦乔	name
あんじゅ	安茹	name
コレット	柯蕾特	name
アルマンディーヌ	阿尔曼汀	name
ジャン	让	name
ダヴィンチ	达芬奇	name
金色の獅子	金狮子
模倣野苺	仿野莓
ソフィー	索菲	name
ビアンカ	碧安卡	name
ブレイク	布莱克	name
ポワゾ	波瓦佐	name
グリス	格里斯	name
アミル	艾米尔	name
テレサ	特蕾莎	name
アレット	阿莱特	name
デューラー	杜拉	name
ミーちゃん	米酱
ネリーナ	奈莉娜	name
ムーラン	穆兰	name
よひら	四宫	name
ニコラス	尼可拉斯	name
アドン	亚登	name
ピエロ	皮耶罗	name
ウィユ	维优	name
ペトマーノ	佩特玛诺	name
ロジェ	罗洁	name
パーシュース	帕修斯	name
フィーア	菲亚	name
ボッティチェリ	波提切利	name
フィヨーラ	菲欧拉	name
アルバーヌ	阿尔巴奴	name
マティア	马蒂亚	name
ヴァルンボン	瓦伦邦	name
アンゲリカ	安洁莉卡	name
アモレ	阿莫蕾	name
ドゥアーネ	杜亚尼	name
ザイファ	扎伊法	name
メナール	梅纳尔	name
ポリーヌ	波利努	name
キュイ	丘伊	name
カルペディア	卡尔佩迪亚	name
エルガー	埃尔加	name
バーガーシュ	巴葛修	name
ミーナ	米娜	name
パガニーニ	帕格尼尼	name
レオニー	莱奥妮	name
エヴァ	伊娃	name
ベア子	熊女孩
クマリザ	熊丽莎
クマロボ	熊机器人
しゃしょー	车掌
ヨシノ	吉野	name
カトレア	卡特蕾雅
巨大クマロボ	巨大熊熊机器人
こうえん	高圆	name
エスティ―	艾丝缇	name
シャティ	夏蒂
防犯に力を入れる議員	致力于防范犯罪的议员
金を盗まれた篤志家	被盗的慈善家
傷心だった男性	伤心的男性
傷心の女性	伤心的女性
窃盗事件の黒幕	盗窃事件的黑幕
傷心だった女性	伤心的女性
ひったくりに遭った女性	遭遇抢劫的女性
陶器店の店主	陶器店店主
傷心の男性	伤心的男性
レイア	蕾亚
分署の警吏	分署的警吏
貴族のような男	贵族般的男子
女性の声	女性的声音
ミストラル伯	米斯特拉尔伯爵
幼馴染の女性	青梅竹马的女性
女子署員	女警员
ヴィルジニア	维尔吉尼亚
タオファ	陶法
ジュエリーデザイナー	珠宝设计师
パルル	帕露露
宝石商	宝石商人
女性芸術家	女性艺术家
男性芸術家	男性艺术家
イヴィディア	伊维迪亚
クピド	丘比特
天使のイマージュ	天使的意象
エッグを獲得した男の子	获得蛋的男孩
カジノを不安視する親	对赌场感到不安的父母
女性従業員	女性员工
従業員たち	员工们
貴族男性	贵族男性
前オーナー	前老板
カジノに反対する住民	反对赌场的居民
貴族女性	贵族女性
幼い女の子	年幼的女孩
女の子の姉	女孩的姐姐
男性従業員	男性员工
フィリスたち	菲莉丝们
中年女性	中年女性
クレプスキュル	克莱普斯库尔
泣いている女性	哭泣的女性
フィリス	菲莉丝
指輪の死の芸術	戒指的死之艺术
コレクターの女	收藏家的女人
モリゾのイマージュ	莫里索的意象
ジュリエンヌ	朱丽叶娜
女性記者	女记者
野卑な男	粗鄙男子
女性議員	女议员
市民の女性	市民女性
先輩議員	资深议员
騙された女性	被骗的女性
一般人の悲鳴	普通人的悲鸣
アテネス新聞の記者	雅典新闻记者
騙された少女	被骗的少女
アリアベル	阿里亚贝尔
会場の声	会场的声音
参加者の男性	参加者男性
暑さの元凶の死の芸術	炎热元凶的死之艺术
ヴェネル	维内尔
軽薄な男	轻浮男子
謎の少女	谜之少女
黒服の女	黑衣女子
身なりのいい女性	衣着得体的女性
露店の女店主	摊贩女店主
女公爵	女公爵
酔っ払った客	醉汉
ビキニの死の芸術	比基尼的死之艺术
水着の女性	泳装女性
水着の女	泳装女子
輪のついた死の芸術	带轮子的死之艺术
ヴィレンタン	维伦坦
センナ	森纳
若い母親	年轻母亲
主催者	主办者
スタッフの声	工作人员的声音
目隠しをした少年	蒙眼少年
少年の母親	少年的母亲
参加者の女性	参加的女性
謎の声	谜之声
鏡写しの少女	镜中少女
元気な女の子	活泼女孩
見物客	围观者
絵が得意な女の子	擅长绘画的女孩
元気な男の子	活泼的男孩
フランシスカス	弗朗西斯卡斯
商人の従業員	商人员工
献身的な商人	献身商人
ナヴィア	娜维娅
誘拐された令嬢	被绑架的千金
依頼主	委托人
物語が好きな少女	喜欢故事的少女
不審な物音	可疑的声响
謎の影	谜之影
怪しい男性	可疑男性
犯人の男性	犯人男性
買い物に来た男性	购物男性
下級騎士	下级骑士
女性の村人	女性村民
死天使たち	死亡天使们
新婚の女性	新婚女性
相談者の女性	咨询者女性
白い牡牛	白色公牛
男性の村人	男性村民
屋台の商人	摊贩
牛たち	牛群
ファンの女の子	粉丝女孩
くれない	红
怯えた男	胆怯男子
芸術家の老人	艺术家老人
エトラ	埃特拉
猿の木像	猴子木像
厄介なファン	麻烦的粉丝
自画像のイマージュ	自画像的映像
猿の木像たち	猿猴木像们
仮装した少年	变装少年
死天使	死亡天使
黒死天使会の女	黑死天使会之女
仮装した少女	变装少女
観光客の女性	女游客
ライフ	生命
怪しい女	可疑女子
粗暴な男性	粗暴男性
散歩中の老人	散步中的老人
ナタリー	娜塔莉
遊んでいる子供	玩耍的孩子
被災した男性	受灾男性
住民の女性	居民女性
オルタ	奥尔塔	It means alternative, and is also used as a nickname for someone's other personality.団体のリーダー	团体领袖
美術学校校長	美术学校校长
大貴族	大贵族
花火師	烟花师
ファンの子供	粉丝的孩子
生徒たち	学生们
デモ団体	示威团体
団体のメンバー	团体成员
アテネス市長	雅典斯市长
デモ参加者	示威参加者
ルナーリヤ	露娜莉娅
ルナーリヤたち	露娜莉娅她们
ライバル店主	竞争对手店主
芸術評論家	艺术评论家
ミストラル家の私兵	米斯特拉尔家私兵
店長の妻	店长之妻
犯罪者	犯罪者
乱暴な客	粗暴的客人
黒死天使会の男	黑死天使会男子
農家のおばあさん	农家老奶奶
雪女の死の芸術	雪女的死之艺术
少年の父親	少年的父亲
シーブル	希布尔
貴婦人	贵妇人
黒死天使会の男女	黑死天使会的男女
少年たち	少年们
ツァオたち	曹们
年配の議員	年长议员
スニューウ	斯纽乌
クレプスキュルたち	克莱普斯库尔们
若い議員	年轻议员
ルノワール	雷诺阿
ルノ	雷诺	Character name, abbreviation of ルノワール花屋の店主	花店店主
走ってきた少年	跑来的少年
大柄の男	魁梧男子
店員の女性	店员女性
宝石チョコ	宝石巧克力
ショコラティエ	巧克力师
